w                            w
w                            w
w                            w
w                            w
w                            w
w                            w
w                            w
w                     w      w
w                     t      w
w                  w w       w
w                 w          w
w s            w             w
w  w  n   w   www          wew
wwwwwwwwwwwwwwwww wwwwwwwwwwww
